####################
#EE....EE....EE....#
#..................#
#..##..~~..##..~~..#
#..................#
#..E...E...E...E...#
#......~~....~~....#
#..................#
#..................#
#..##....##....##..#
#..........P.......#
#....####..####....#
#....##..#H#..##...#
#....####..####....#
####################
